date,sheet,tsa,location,pedi_vent_avail,pedi_vents_in_use,adult_vents_avail,adult_vents_in_use,total_vents_avail,total_vents_in_use,pedi_bi_pap_avail,pedi_bi_pap_in_use,adult_bi_pap_avail,adult_bi_pap_in_use,total_bi_pap_avail,total_bi_pap_in_use,total_anesthesia_vents_in_use,total_covid_on_vents,anesthsia_vents_avail
2020-05-12,Vent Availability,TSA-A,Amarillo,26,4,82,33,108,37,0,0,52,15,52,15,0,0,25
2020-05-12,Vent Availability,TSA-B,Lubbock,7,0,147,47,154,47,1,0,73,19,74,19,0,5,22
2020-05-12,Vent Availability,TSA-C,Witchita Falls,2,0,51,8,53,8,0,0,10,4,10,4,0,0,27
2020-05-12,Vent Availability,TSA-D,Abilene,9,0,52,10,61,10,0,0,20,3,20,3,0,0,29
2020-05-12,Vent Availability,TSA-E,Dallas/Ft. Worth,309,123,1004,657,1313,780,67,22,811,278,878,300,153,165,379
2020-05-12,Vent Availability,TSA-F,Paris,12,0,81,23,93,23,15,0,54,27,69,27,0,6,38
2020-05-12,Vent Availability,TSA-G,Longview/Tyler,72,6,163,68,235,74,27,0,154,47,181,47,1,17,24
2020-05-12,Vent Availability,TSA-H,Lufkin,31,5,75,16,106,21,0,0,47,12,47,12,0,4,22
2020-05-12,Vent Availability,TSA-I,El Paso,67,10,206,68,273,78,5,0,109,26,114,26,5,19,49
2020-05-12,Vent Availability,TSA-J,Midland/Odessa,36,4,174,14,210,18,17,0,43,18,60,18,0,0,34
2020-05-12,Vent Availability,TSA-K,San Angelo,4,0,42,0,46,0,0,0,0,0,0,0,0,0,3
2020-05-12,Vent Availability,TSA-L,Belton/Killeen,25,5,138,34,163,39,9,0,98,12,107,12,1,4,50
2020-05-12,Vent Availability,TSA-M,Waco,0,0,62,14,62,14,0,0,63,0,63,0,0,1,13
2020-05-12,Vent Availability,TSA-N,Bryan/College Station,7,0,44,12,51,12,2,0,29,3,31,3,0,2,28
2020-05-12,Vent Availability,TSA-O,Austin,87,30,302,101,389,131,12,0,172,54,184,54,26,16,132
2020-05-12,Vent Availability,TSA-P,San Antonio,73,45,820,636,893,681,14,6,312,252,326,258,19,25,183
2020-05-12,Vent Availability,TSA-Q,Houston,305,149,1004,547,1309,696,51,13,666,307,717,320,161,118,233
2020-05-12,Vent Availability,TSA-R,Galveston,33,5,170,79,203,84,10,39,122,44,132,83,34,16,126
2020-05-12,Vent Availability,TSA-S,Victoria,4,0,45,8,49,8,0,0,22,5,22,5,0,3,26
2020-05-12,Vent Availability,TSA-T,Laredo,21,0,54,24,75,24,5,5,33,12,38,17,0,7,6
2020-05-12,Vent Availability,TSA-U,Corpus Christi,60,9,111,25,171,34,5,0,96,41,101,41,0,1,16
2020-05-12,Vent Availability,TSA-V,Lower Rio Grande Valley,33,12,209,83,242,95,16,0,148,69,164,69,9,3,47
2020-05-12,Vent Availability,Total,Texas,1223,407,5036,2507,6259,2914,256,85,3134,1248,3390,1333,409,412,1512
2020-05-14,Vent Availability,TSA-A,Amarillo,26,3,80,36,106,39,0,0,56,12,56,12,0,0,25
2020-05-14,Vent Availability,TSA-B,Lubbock,10,0,149,45,159,45,1,0,71,14,72,14,0,5,25
2020-05-14,Vent Availability,TSA-C,Witchita Falls,2,0,51,8,53,8,0,0,10,4,10,4,0,0,29
2020-05-14,Vent Availability,TSA-D,Abilene,9,0,53,10,62,10,0,0,20,1,20,1,0,0,28
2020-05-14,Vent Availability,TSA-E,Dallas/Ft. Worth,302,133,1030,637,1332,770,70,19,807,298,877,317,164,168,346
2020-05-14,Vent Availability,TSA-F,Paris,12,0,81,24,93,24,14,0,54,26,68,26,0,5,38
2020-05-14,Vent Availability,TSA-G,Longview/Tyler,75,6,164,67,239,73,30,0,153,49,183,49,1,18,23
2020-05-14,Vent Availability,TSA-H,Lufkin,28,1,76,22,104,23,0,0,37,21,37,21,0,1,22
2020-05-14,Vent Availability,TSA-I,El Paso,68,19,207,69,275,88,5,1,110,35,115,36,3,20,50
2020-05-14,Vent Availability,TSA-J,Midland/Odessa,38,2,174,15,212,17,17,0,50,14,67,14,0,0,34
2020-05-14,Vent Availability,TSA-K,San Angelo,4,0,42,0,46,0,0,0,0,0,0,0,0,0,3
2020-05-14,Vent Availability,TSA-L,Belton/Killeen,20,7,151,50,171,57,5,0,111,25,116,25,0,5,27
2020-05-14,Vent Availability,TSA-M,Waco,0,0,58,17,58,17,0,0,59,2,59,2,0,0,12
2020-05-14,Vent Availability,TSA-N,Bryan/College Station,7,0,46,10,53,10,2,0,26,5,28,5,0,3,28
2020-05-14,Vent Availability,TSA-O,Austin,84,32,311,104,395,136,11,0,176,46,187,46,12,17,99
2020-05-14,Vent Availability,TSA-P,San Antonio,73,45,820,636,893,681,14,6,312,252,326,258,19,17,183
2020-05-14,Vent Availability,TSA-Q,Houston,306,123,966,544,1272,667,52,13,704,305,756,318,139,106,217
2020-05-14,Vent Availability,TSA-R,Galveston,38,7,187,80,225,87,15,3,152,43,167,46,13,18,71
2020-05-14,Vent Availability,TSA-S,Victoria,4,4,45,8,49,12,0,0,24,3,24,3,0,2,26
2020-05-14,Vent Availability,TSA-T,Laredo,21,0,58,29,79,29,10,3,34,7,44,10,0,7,8
2020-05-14,Vent Availability,TSA-U,Corpus Christi,62,5,113,30,175,35,5,0,103,35,108,35,0,0,16
2020-05-14,Vent Availability,TSA-V,Lower Rio Grande Valley,31,3,230,81,261,84,17,0,147,73,164,73,6,1,48
2020-05-14,Vent Availability,Total,Texas,1220,390,5092,2522,6312,2912,268,45,3216,1270,3484,1315,357,393,1358
2020-05-16,Vent Availability,TSA-A,Amarillo,29,4,80,28,109,32,0,0,41,16,41,16,0,0,25
2020-05-16,Vent Availability,TSA-B,Lubbock,10,0,159,34,169,34,1,0,68,19,69,19,0,5,28
2020-05-16,Vent Availability,TSA-C,Witchita Falls,2,0,51,8,53,8,0,0,10,4,10,4,0,0,30
2020-05-16,Vent Availability,TSA-D,Abilene,9,0,32,0,41,0,0,0,10,0,10,0,0,0,23
2020-05-16,Vent Availability,TSA-E,Dallas/Ft. Worth,299,119,977,594,1276,713,67,22,737,328,804,350,110,150,356
2020-05-16,Vent Availability,TSA-F,Paris,12,0,83,23,95,23,10,0,54,25,64,25,0,6,38
2020-05-16,Vent Availability,TSA-G,Longview/Tyler,74,5,163,64,237,69,30,0,150,49,180,49,0,14,22
2020-05-16,Vent Availability,TSA-H,Lufkin,33,6,65,19,98,25,0,0,40,9,40,9,0,0,24
2020-05-16,Vent Availability,TSA-I,El Paso,69,10,187,73,256,83,5,1,103,41,108,42,3,14,58
2020-05-16,Vent Availability,TSA-J,Midland/Odessa,38,2,167,19,205,21,17,0,58,16,75,16,0,0,38
2020-05-16,Vent Availability,TSA-K,San Angelo,4,0,36,0,40,0,0,0,0,0,0,0,0,0,15
2020-05-16,Vent Availability,TSA-L,Belton/Killeen,21,7,68,47,89,54,23,0,65,23,88,23,0,6,51
2020-05-16,Vent Availability,TSA-M,Waco,0,0,53,21,53,21,0,0,53,4,53,4,0,0,13
2020-05-16,Vent Availability,TSA-N,Bryan/College Station,7,0,39,14,46,14,2,0,27,6,29,6,0,2,24
2020-05-16,Vent Availability,TSA-O,Austin,99,32,29,88,128,120,15,0,148,39,163,39,6,15,96
2020-05-16,Vent Availability,TSA-P,San Antonio,73,43,817,642,890,685,14,7,312,240,326,247,13,19,183
2020-05-16,Vent Availability,TSA-Q,Houston,302,149,951,565,1253,714,102,13,681,331,783,344,30,90,269
2020-05-16,Vent Availability,TSA-R,Galveston,38,7,173,81,211,88,13,3,134,50,147,53,11,30,94
2020-05-16,Vent Availability,TSA-S,Victoria,3,4,44,9,47,13,0,0,20,7,20,7,0,2,26
2020-05-16,Vent Availability,TSA-T,Laredo,21,0,57,21,78,21,8,3,30,12,38,15,0,8,6
2020-05-16,Vent Availability,TSA-U,Corpus Christi,46,10,112,28,158,38,5,0,111,30,116,30,0,0,16
2020-05-16,Vent Availability,TSA-V,Lower Rio Grande Valley,47,3,218,73,265,76,17,0,148,59,165,59,2,2,47
2020-05-16,Vent Availability,Total,Texas,1236,401,4561,2451,5797,2852,329,49,3000,1308,3329,1357,175,363,1482
2020-05-17,Vent Availability,TSA-A,Amarillo,28,6,78,30,106,36,0,0,40,16,40,16,0,0,25
2020-05-17,Vent Availability,TSA-B,Lubbock,10,0,148,35,158,35,1,0,68,19,69,19,0,5,30
2020-05-17,Vent Availability,TSA-C,Witchita Falls,2,0,51,8,53,8,0,0,10,4,10,4,0,0,26
2020-05-17,Vent Availability,TSA-D,Abilene,9,0,53,10,62,10,0,0,21,1,21,1,0,0,29
2020-05-17,Vent Availability,TSA-E,Dallas/Ft. Worth,314,120,977,565,1291,685,68,21,698,306,766,327,111,160,320
2020-05-17,Vent Availability,TSA-F,Paris,12,0,86,18,98,18,10,0,53,26,63,26,0,6,38
2020-05-17,Vent Availability,TSA-G,Longview/Tyler,77,5,167,63,244,68,30,0,154,42,184,42,0,12,22
2020-05-17,Vent Availability,TSA-H,Lufkin,29,13,63,19,92,32,0,0,39,9,39,9,0,2,24
2020-05-17,Vent Availability,TSA-I,El Paso,70,7,199,63,269,70,5,1,97,44,102,45,2,16,63
2020-05-17,Vent Availability,TSA-J,Midland/Odessa,38,2,167,13,205,15,17,0,58,16,75,16,0,0,38
2020-05-17,Vent Availability,TSA-K,San Angelo,4,0,39,0,43,0,0,0,0,0,0,0,0,0,15
2020-05-17,Vent Availability,TSA-L,Belton/Killeen,18,7,78,47,96,54,5,0,57,30,62,30,4,5,19
2020-05-17,Vent Availability,TSA-M,Waco,0,0,53,19,53,19,0,0,50,7,50,7,0,2,12
2020-05-17,Vent Availability,TSA-N,Bryan/College Station,7,0,41,15,48,15,1,0,25,5,26,5,0,2,24
2020-05-17,Vent Availability,TSA-O,Austin,98,31,275,102,373,133,15,0,153,40,168,40,6,18,97
2020-05-17,Vent Availability,TSA-P,San Antonio,71,30,807,184,878,214,10,6,295,64,305,70,12,30,183
2020-05-17,Vent Availability,TSA-Q,Houston,297,132,906,509,1203,641,123,28,664,309,787,337,52,97,249
2020-05-17,Vent Availability,TSA-R,Galveston,29,8,133,62,162,70,13,0,80,38,93,38,1,30,70
2020-05-17,Vent Availability,TSA-S,Victoria,3,1,47,6,50,7,0,0,21,6,21,6,0,2,26
2020-05-17,Vent Availability,TSA-T,Laredo,21,0,57,21,78,21,8,3,30,14,38,17,0,8,6
2020-05-17,Vent Availability,TSA-U,Corpus Christi,44,13,110,28,154,41,5,0,105,36,110,36,0,0,16
2020-05-17,Vent Availability,TSA-V,Lower Rio Grande Valley,30,3,227,72,257,75,19,0,149,56,168,56,3,5,47
2020-05-17,Vent Availability,Total,Texas,1211,378,4762,1889,5973,2267,330,59,2867,1088,3197,1147,191,400,1379
2020-05-01,Vent Availability,TSA-A,Amarillo,27,2,70,41,97,43,0,0,53,13,53,13,0,0,25
2020-05-01,Vent Availability,TSA-B,Lubbock,9,0,130,59,139,59,1,0,68,32,69,32,0,14,20
2020-05-01,Vent Availability,TSA-C,Witchita Falls,2,0,41,8,43,8,0,0,10,5,10,5,0,0,29
2020-05-01,Vent Availability,TSA-D,Abilene,9,0,53,0,62,0,0,0,0,0,0,0,0,0,28
2020-05-01,Vent Availability,TSA-E,Dallas/Ft. Worth,274,124,1140,644,1414,768,73,18,833,352,906,370,165,153,365
2020-05-01,Vent Availability,TSA-F,Paris,12,0,82,24,94,24,15,0,65,10,80,10,0,6,38
2020-05-01,Vent Availability,TSA-G,Longview/Tyler,82,2,180,61,262,63,25,0,153,49,178,49,0,16,23
2020-05-01,Vent Availability,TSA-H,Lufkin,35,0,69,21,104,21,0,0,36,17,36,17,0,1,15
2020-05-01,Vent Availability,TSA-I,El Paso,70,7,206,60,276,67,4,0,115,22,119,22,19,19,50
2020-05-01,Vent Availability,TSA-J,Midland/Odessa,36,4,173,12,209,16,13,0,57,8,70,8,0,0,33
2020-05-01,Vent Availability,TSA-K,San Angelo,4,0,39,0,43,0,0,0,0,0,0,0,0,0,11
2020-05-01,Vent Availability,TSA-L,Belton/Killeen,26,9,152,29,178,38,5,0,126,13,131,13,0,4,50
2020-05-01,Vent Availability,TSA-M,Waco,0,0,62,14,62,14,0,0,55,8,55,8,0,1,13
2020-05-01,Vent Availability,TSA-N,Bryan/College Station,6,0,37,8,43,8,2,0,24,4,26,4,0,1,25
2020-05-01,Vent Availability,TSA-O,Austin,76,38,308,83,384,121,14,0,175,53,189,53,0,19,139
2020-05-01,Vent Availability,TSA-P,San Antonio,68,43,815,653,883,696,14,7,308,232,322,239,16,22,183
2020-05-01,Vent Availability,TSA-Q,Houston,309,135,1110,501,1419,636,113,20,684,284,797,304,103,114,229
2020-05-01,Vent Availability,TSA-R,Galveston,36,7,164,75,200,82,0,27,129,44,129,71,32,26,145
2020-05-01,Vent Availability,TSA-S,Victoria,4,0,42,11,46,11,0,0,24,3,24,3,0,1,26
2020-05-01,Vent Availability,TSA-T,Laredo,15,0,53,22,68,22,5,0,42,5,47,5,0,10,8
2020-05-01,Vent Availability,TSA-U,Corpus Christi,65,16,110,45,175,61,5,0,98,49,103,49,0,2,16
2020-05-01,Vent Availability,TSA-V,Lower Rio Grande Valley,41,3,243,90,284,93,34,0,173,65,207,65,8,9,46
2020-05-01,Vent Availability,Total,Texas,1206,390,5279,2461,6485,2851,323,72,3228,1268,3551,1340,343,418,1517
2020-05-03,Vent Availability,TSA-A,Amarillo,28,1,72,40,100,41,0,0,47,20,47,20,0,0,25
2020-05-03,Vent Availability,TSA-B,Lubbock,9,0,142,48,151,48,1,0,73,18,74,18,0,9,28
2020-05-03,Vent Availability,TSA-C,Witchita Falls,2,0,53,8,55,8,0,0,10,4,10,4,0,0,34
2020-05-03,Vent Availability,TSA-D,Abilene,9,0,53,0,62,0,0,0,0,0,0,0,0,0,28
2020-05-03,Vent Availability,TSA-E,Dallas/Ft. Worth,274,121,970,521,1244,642,68,23,832,271,900,294,124,136,339
2020-05-03,Vent Availability,TSA-F,Paris,12,0,87,18,99,18,16,0,61,13,77,13,0,7,38
2020-05-03,Vent Availability,TSA-G,Longview/Tyler,89,2,175,55,264,57,30,0,158,41,188,41,0,17,23
2020-05-03,Vent Availability,TSA-H,Lufkin,40,0,84,9,124,9,0,0,41,12,41,12,0,0,30
2020-05-03,Vent Availability,TSA-I,El Paso,69,5,207,56,276,61,5,0,99,28,104,28,15,19,47
2020-05-03,Vent Availability,TSA-J,Midland/Odessa,36,4,175,14,211,18,13,0,50,17,63,17,0,0,39
2020-05-03,Vent Availability,TSA-K,San Angelo,4,0,34,0,38,0,0,0,0,0,0,0,0,0,11
2020-05-03,Vent Availability,TSA-L,Belton/Killeen,19,5,92,31,111,36,5,0,95,8,100,8,3,2,55
2020-05-03,Vent Availability,TSA-M,Waco,0,0,65,9,65,9,0,0,60,2,60,2,0,1,16
2020-05-03,Vent Availability,TSA-N,Bryan/College Station,7,0,50,6,57,6,2,0,32,0,34,0,0,2,19
2020-05-03,Vent Availability,TSA-O,Austin,88,36,295,71,383,107,14,0,168,61,182,61,1,11,110
2020-05-03,Vent Availability,TSA-P,San Antonio,73,53,815,645,888,698,14,9,308,241,322,250,10,18,183
2020-05-03,Vent Availability,TSA-Q,Houston,283,123,960,507,1243,630,59,16,692,238,751,254,27,89,254
2020-05-03,Vent Availability,TSA-R,Galveston,42,3,206,71,248,74,21,3,143,51,164,54,5,17,142
2020-05-03,Vent Availability,TSA-S,Victoria,4,0,43,10,47,10,0,0,21,6,21,6,0,2,26
2020-05-03,Vent Availability,TSA-T,Laredo,14,0,51,27,65,27,5,0,36,5,41,5,0,8,6
2020-05-03,Vent Availability,TSA-U,Corpus Christi,51,14,111,32,162,46,5,0,106,31,111,31,0,0,16
2020-05-03,Vent Availability,TSA-V,Lower Rio Grande Valley,47,4,223,71,270,75,34,0,164,59,198,59,0,8,48
2020-05-03,Vent Availability,Total,Texas,1200,371,4963,2249,6163,2620,292,51,3196,1126,3488,1177,185,346,1517
2020-05-04,Vent Availability,TSA-A,Amarillo,28,1,76,37,104,38,0,0,53,14,53,14,0,0,24
2020-05-04,Vent Availability,TSA-B,Lubbock,7,0,146,54,153,54,1,0,66,25,67,25,0,80,22
2020-05-04,Vent Availability,TSA-C,Witchita Falls,2,0,49,8,51,8,0,0,10,4,10,4,0,0,29
2020-05-04,Vent Availability,TSA-D,Abilene,9,0,53,0,62,0,0,0,0,0,0,0,0,0,28
2020-05-04,Vent Availability,TSA-E,Dallas/Ft. Worth,280,113,1011,572,1291,685,68,23,829,280,897,303,147,136,385
2020-05-04,Vent Availability,TSA-F,Paris,12,0,87,19,99,19,14,0,52,24,66,24,0,3,38
2020-05-04,Vent Availability,TSA-G,Longview/Tyler,86,2,180,56,266,58,35,0,159,44,194,44,0,15,23
2020-05-04,Vent Availability,TSA-H,Lufkin,36,0,81,17,117,17,0,0,38,15,38,15,0,2,22
2020-05-04,Vent Availability,TSA-I,El Paso,66,7,201,69,267,76,5,0,106,28,111,28,15,22,54
2020-05-04,Vent Availability,TSA-J,Midland/Odessa,36,4,174,12,210,16,13,0,55,10,68,10,0,0,37
2020-05-04,Vent Availability,TSA-K,San Angelo,4,0,38,0,42,0,0,0,0,0,0,0,0,0,13
2020-05-04,Vent Availability,TSA-L,Belton/Killeen,27,5,160,36,187,41,5,0,115,11,120,11,0,5,46
2020-05-04,Vent Availability,TSA-M,Waco,0,0,64,12,64,12,0,0,61,2,61,2,0,1,11
2020-05-04,Vent Availability,TSA-N,Bryan/College Station,7,0,52,11,59,11,2,0,32,2,34,2,0,2,20
2020-05-04,Vent Availability,TSA-O,Austin,92,34,312,78,404,112,14,0,172,59,186,59,12,13,140
2020-05-04,Vent Availability,TSA-P,San Antonio,73,45,819,640,892,685,14,7,308,233,322,240,25,14,183
2020-05-04,Vent Availability,TSA-Q,Houston,305,123,1257,529,1562,652,114,8,741,306,855,314,115,131,282
2020-05-04,Vent Availability,TSA-R,Galveston,37,0,173,52,210,52,6,29,133,66,139,95,11,19,73
2020-05-04,Vent Availability,TSA-S,Victoria,4,0,48,5,52,5,0,0,21,6,21,6,0,2,26
2020-05-04,Vent Availability,TSA-T,Laredo,13,0,51,27,64,27,5,0,31,10,36,10,0,9,6
2020-05-04,Vent Availability,TSA-U,Corpus Christi,54,15,127,35,181,50,4,1,123,40,127,41,0,0,16
2020-05-04,Vent Availability,TSA-V,Lower Rio Grande Valley,35,5,243,70,278,75,37,0,167,62,204,62,9,8,48
2020-05-04,Vent Availability,Total,Texas,1213,354,5402,2339,6615,2693,337,68,3272,1241,3609,1309,334,462,1526
2020-05-05,Vent Availability,TSA-A,Amarillo,30,1,78,34,108,35,0,0,53,14,53,14,0,0,24
2020-05-05,Vent Availability,TSA-B,Lubbock,7,0,143,60,150,60,1,0,63,28,64,28,0,21,25
2020-05-05,Vent Availability,TSA-C,Witchita Falls,2,0,49,8,51,8,0,0,10,4,10,4,0,0,30
2020-05-05,Vent Availability,TSA-D,Abilene,9,0,52,0,61,0,0,0,0,0,0,0,0,0,28
2020-05-05,Vent Availability,TSA-E,Dallas/Ft. Worth,281,143,1026,623,1307,766,69,22,805,304,874,326,137,133,380
2020-05-05,Vent Availability,TSA-F,Paris,12,0,86,19,98,19,13,0,54,23,67,23,0,3,38
2020-05-05,Vent Availability,TSA-G,Longview/Tyler,102,2,185,91,287,93,13,0,160,69,173,69,0,21,24
2020-05-05,Vent Availability,TSA-H,Lufkin,36,0,81,17,117,17,0,0,38,15,38,15,0,0,18
2020-05-05,Vent Availability,TSA-I,El Paso,60,6,205,74,265,80,5,0,105,28,110,28,15,18,49
2020-05-05,Vent Availability,TSA-J,Midland/Odessa,36,4,177,6,213,10,13,0,51,16,64,16,0,0,37
2020-05-05,Vent Availability,TSA-K,San Angelo,4,0,41,0,45,0,0,0,0,0,0,0,0,0,6
2020-05-05,Vent Availability,TSA-L,Belton/Killeen,33,3,149,39,182,42,5,0,116,12,121,12,2,3,51
2020-05-05,Vent Availability,TSA-M,Waco,0,0,64,12,64,12,0,0,58,5,58,5,0,1,12
2020-05-05,Vent Availability,TSA-N,Bryan/College Station,7,0,42,15,49,15,2,0,30,10,32,10,0,2,27
2020-05-05,Vent Availability,TSA-O,Austin,63,29,299,78,362,107,10,0,160,50,170,50,13,16,98
2020-05-05,Vent Availability,TSA-P,San Antonio,73,39,815,631,888,670,14,7,425,308,439,315,25,24,183
2020-05-05,Vent Availability,TSA-Q,Houston,305,123,1257,529,1562,652,114,8,741,306,855,314,109,124,234
2020-05-05,Vent Availability,TSA-R,Galveston,37,0,173,52,210,52,6,29,133,66,139,95,8,21,138
2020-05-05,Vent Availability,TSA-S,Victoria,4,0,38,14,42,14,0,0,24,3,24,3,0,2,26
2020-05-05,Vent Availability,TSA-T,Laredo,13,0,53,25,66,25,5,0,30,13,35,13,0,10,6
2020-05-05,Vent Availability,TSA-U,Corpus Christi,49,19,108,35,157,54,4,0,96,40,100,40,0,0,16
2020-05-05,Vent Availability,TSA-V,Lower Rio Grande Valley,34,6,239,79,273,85,34,0,167,59,201,59,8,6,48
2020-05-05,Vent Availability,Total,Texas,1197,375,5360,2441,6557,2816,308,66,3319,1373,3627,1439,317,405,1498
2020-05-06,Vent Availability,TSA-A,Amarillo,30,1,78,34,108,35,0,0,49,19,49,19,0,0,25
2020-05-06,Vent Availability,TSA-B,Lubbock,7,0,145,54,152,54,1,0,61,30,62,30,0,20,22
2020-05-06,Vent Availability,TSA-C,Witchita Falls,2,0,49,8,51,8,0,0,10,4,10,4,0,0,26
2020-05-06,Vent Availability,TSA-D,Abilene,9,0,52,0,61,0,0,0,0,0,0,0,0,0,28
2020-05-06,Vent Availability,TSA-E,Dallas/Ft. Worth,283,121,1014,576,1297,697,69,22,806,307,875,329,143,154,329
2020-05-06,Vent Availability,TSA-F,Paris,12,0,83,22,95,22,16,0,59,15,75,15,0,3,38
2020-05-06,Vent Availability,TSA-G,Longview/Tyler,76,1,156,73,232,74,29,0,154,49,183,49,1,22,23
2020-05-06,Vent Availability,TSA-H,Lufkin,41,0,83,15,124,15,0,0,29,15,29,15,0,2,21
2020-05-06,Vent Availability,TSA-I,El Paso,68,6,197,72,265,78,5,0,104,23,109,23,7,23,47
2020-05-06,Vent Availability,TSA-J,Midland/Odessa,36,4,177,9,213,13,13,0,48,17,61,17,0,0,34
2020-05-06,Vent Availability,TSA-K,San Angelo,4,0,41,0,45,0,0,0,0,0,0,0,0,0,6
2020-05-06,Vent Availability,TSA-L,Belton/Killeen,25,3,134,31,159,34,5,0,122,14,127,14,0,0,71
2020-05-06,Vent Availability,TSA-M,Waco,0,0,65,11,65,11,0,0,62,1,62,1,0,1,12
2020-05-06,Vent Availability,TSA-N,Bryan/College Station,7,0,45,12,52,12,2,0,29,2,31,2,0,2,27
2020-05-06,Vent Availability,TSA-O,Austin,66,31,328,82,394,113,10,0,172,45,182,45,2,12,123
2020-05-06,Vent Availability,TSA-P,San Antonio,73,40,815,643,888,683,14,7,315,241,329,248,25,20,183
2020-05-06,Vent Availability,TSA-Q,Houston,305,123,1257,529,1562,652,114,8,741,306,855,314,111,142,224
2020-05-06,Vent Availability,TSA-R,Galveston,39,3,183,73,222,76,12,3,132,111,144,114,32,15,121
2020-05-06,Vent Availability,TSA-S,Victoria,4,0,41,11,45,11,0,0,23,4,23,4,0,2,26
2020-05-06,Vent Availability,TSA-T,Laredo,13,0,53,25,66,25,5,0,29,12,34,12,0,9,6
2020-05-06,Vent Availability,TSA-U,Corpus Christi,42,15,101,37,143,52,5,0,92,47,97,47,0,0,16
2020-05-06,Vent Availability,TSA-V,Lower Rio Grande Valley,34,5,221,79,255,84,34,0,162,63,196,63,0,7,43
2020-05-06,Vent Availability,Total,Texas,1176,353,5318,2396,6494,2749,334,40,3199,1325,3533,1365,321,434,1451
2020-05-07,Vent Availability,TSA-A,Amarillo,28,3,78,34,106,37,0,0,53,14,53,14,0,0,25
2020-05-07,Vent Availability,TSA-B,Lubbock,9,0,143,48,152,48,1,0,68,24,69,24,0,9,22
2020-05-07,Vent Availability,TSA-C,Witchita Falls,2,0,51,8,53,8,0,0,10,4,10,4,0,0,26
2020-05-07,Vent Availability,TSA-D,Abilene,9,0,53,0,62,0,0,0,0,0,0,0,0,0,28
2020-05-07,Vent Availability,TSA-E,Dallas/Ft. Worth,278,89,926,554,1204,643,56,7,772,269,828,276,125,147,355
2020-05-07,Vent Availability,TSA-F,Paris,12,0,82,24,94,24,14,0,60,17,74,17,0,3,38
2020-05-07,Vent Availability,TSA-G,Longview/Tyler,64,1,144,86,208,87,26,0,151,49,177,49,1,20,23
2020-05-07,Vent Availability,TSA-H,Lufkin,40,0,84,15,124,15,0,0,46,13,46,13,0,3,21
2020-05-07,Vent Availability,TSA-I,El Paso,69,6,208,66,277,72,5,0,100,27,105,27,4,24,49
2020-05-07,Vent Availability,TSA-J,Midland/Odessa,35,5,181,8,216,13,13,0,47,18,60,18,0,0,33
2020-05-07,Vent Availability,TSA-K,San Angelo,4,0,39,0,43,0,0,0,0,0,0,0,0,0,6
2020-05-07,Vent Availability,TSA-L,Belton/Killeen,0,0,109,29,109,29,0,0,104,9,104,9,0,2,59
2020-05-07,Vent Availability,TSA-M,Waco,0,0,64,12,64,12,0,0,61,2,61,2,0,1,10
2020-05-07,Vent Availability,TSA-N,Bryan/College Station,7,0,52,6,59,6,2,0,30,1,32,1,0,1,25
2020-05-07,Vent Availability,TSA-O,Austin,76,42,322,102,398,144,10,0,166,66,176,66,8,13,158
2020-05-07,Vent Availability,TSA-P,San Antonio,73,41,817,643,890,684,14,7,312,251,326,258,23,27,183
2020-05-07,Vent Availability,TSA-Q,Houston,303,125,1043,541,1346,666,169,10,673,279,842,289,135,105,231
2020-05-07,Vent Availability,TSA-R,Galveston,34,4,175,64,209,68,9,9,137,48,146,57,8,14,80
2020-05-07,Vent Availability,TSA-S,Victoria,4,0,45,7,49,7,0,0,24,3,24,3,0,2,26
2020-05-07,Vent Availability,TSA-T,Laredo,13,0,55,23,68,23,5,0,32,9,37,9,0,9,6
2020-05-07,Vent Availability,TSA-U,Corpus Christi,46,11,106,32,152,43,5,0,89,49,94,49,0,0,16
2020-05-07,Vent Availability,TSA-V,Lower Rio Grande Valley,35,2,213,82,248,84,34,0,156,62,190,62,0,6,45
2020-05-07,Vent Availability,Total,Texas,1141,329,4990,2384,6131,2713,363,33,3091,1214,3454,1247,304,386,1465
2020-05-08,Vent Availability,TSA-A,Amarillo,31,2,77,35,108,37,0,0,53,14,53,14,0,0,34
2020-05-08,Vent Availability,TSA-B,Lubbock,7,1,142,52,149,53,1,0,72,20,73,20,0,7,28
2020-05-08,Vent Availability,TSA-C,Witchita Falls,2,0,51,8,53,8,0,0,10,4,10,4,0,0,27
2020-05-08,Vent Availability,TSA-D,Abilene,9,0,53,0,62,0,0,0,0,0,0,0,0,0,28
2020-05-08,Vent Availability,TSA-E,Dallas/Ft. Worth,319,120,1050,564,1369,684,68,23,756,292,824,315,130,138,346
2020-05-08,Vent Availability,TSA-F,Paris,12,0,84,20,96,20,16,0,59,19,75,19,0,5,38
2020-05-08,Vent Availability,TSA-G,Longview/Tyler,68,3,155,75,223,78,35,0,163,39,198,39,1,18,23
2020-05-08,Vent Availability,TSA-H,Lufkin,40,0,84,15,124,15,0,0,46,13,46,13,0,3,20
2020-05-08,Vent Availability,TSA-I,El Paso,61,8,217,69,278,77,5,0,100,24,105,24,4,20,50
2020-05-08,Vent Availability,TSA-J,Midland/Odessa,35,5,182,13,217,18,13,0,46,15,59,15,0,0,33
2020-05-08,Vent Availability,TSA-K,San Angelo,4,0,40,0,44,0,0,0,0,0,0,0,0,0,6
2020-05-08,Vent Availability,TSA-L,Belton/Killeen,22,3,133,37,155,40,5,0,109,13,114,13,0,2,61
2020-05-08,Vent Availability,TSA-M,Waco,0,0,61,15,61,15,0,0,61,2,61,2,0,1,12
2020-05-08,Vent Availability,TSA-N,Bryan/College Station,6,0,36,12,42,12,2,0,24,3,26,3,0,2,24
2020-05-08,Vent Availability,TSA-O,Austin,62,17,303,87,365,104,10,0,173,59,183,59,20,13,136
2020-05-08,Vent Availability,TSA-P,San Antonio,73,45,814,642,887,687,14,8,312,251,326,259,16,41,183
2020-05-08,Vent Availability,TSA-Q,Houston,294,88,1049,564,1343,652,118,7,745,288,863,295,136,110,253
2020-05-08,Vent Availability,TSA-R,Galveston,34,4,175,64,209,68,9,9,137,48,146,57,9,37,170
2020-05-08,Vent Availability,TSA-S,Victoria,4,0,45,7,49,7,0,0,21,6,21,6,0,2,26
2020-05-08,Vent Availability,TSA-T,Laredo,21,0,55,23,76,23,5,0,36,7,41,7,0,10,6
2020-05-08,Vent Availability,TSA-U,Corpus Christi,51,13,102,35,153,48,5,0,95,42,100,42,0,0,16
2020-05-08,Vent Availability,TSA-V,Lower Rio Grande Valley,35,4,235,77,270,81,34,0,151,62,185,62,1,6,45
2020-05-08,Vent Availability,Total,Texas,1190,313,5143,2414,6333,2727,340,47,3169,1221,3509,1268,317,415,1565
2020-05-09,Vent Availability,TSA-A,Amarillo,28,3,73,36,101,39,0,0,54,13,54,13,0,0,25
2020-05-09,Vent Availability,TSA-B,Lubbock,7,1,143,51,150,52,1,0,70,22,71,22,0,5,28
2020-05-09,Vent Availability,TSA-C,Witchita Falls,2,0,51,8,53,8,0,0,10,4,10,4,0,0,31
2020-05-09,Vent Availability,TSA-D,Abilene,9,0,49,1,58,1,0,0,19,1,19,1,0,0,28
2020-05-09,Vent Availability,TSA-E,Dallas/Ft. Worth,316,164,977,631,1293,795,68,23,732,293,800,316,104,157,337
2020-05-09,Vent Availability,TSA-F,Paris,12,0,83,20,95,20,16,0,60,18,76,18,0,4,38
2020-05-09,Vent Availability,TSA-G,Longview/Tyler,75,5,166,62,241,67,35,0,158,43,193,43,1,15,23
2020-05-09,Vent Availability,TSA-H,Lufkin,29,0,69,23,98,23,0,0,40,8,40,8,0,3,28
2020-05-09,Vent Availability,TSA-I,El Paso,67,11,208,67,275,78,5,0,94,27,99,27,4,20,54
2020-05-09,Vent Availability,TSA-J,Midland/Odessa,35,5,179,14,214,19,17,0,51,15,68,15,0,0,33
2020-05-09,Vent Availability,TSA-K,San Angelo,4,0,41,0,45,0,0,0,0,0,0,0,0,0,6
2020-05-09,Vent Availability,TSA-L,Belton/Killeen,24,3,85,35,109,38,5,0,95,13,100,13,0,4,57
2020-05-09,Vent Availability,TSA-M,Waco,0,0,41,11,41,11,0,0,33,2,33,2,0,1,13
2020-05-09,Vent Availability,TSA-N,Bryan/College Station,7,0,45,10,52,10,25,0,31,3,56,3,0,2,24
2020-05-09,Vent Availability,TSA-O,Austin,59,30,297,89,356,119,6,1,153,60,159,61,8,13,108
2020-05-09,Vent Availability,TSA-P,San Antonio,73,45,811,637,884,682,14,6,312,260,326,266,17,22,183
2020-05-09,Vent Availability,TSA-Q,Houston,284,81,984,481,1268,562,90,18,679,267,769,285,34,105,280
2020-05-09,Vent Availability,TSA-R,Galveston,47,0,139,52,186,52,37,0,123,44,160,44,5,11,130
2020-05-09,Vent Availability,TSA-S,Victoria,4,0,43,9,47,9,0,0,22,5,22,5,0,2,26
2020-05-09,Vent Availability,TSA-T,Laredo,21,0,54,24,75,24,5,5,36,9,41,14,0,10,6
2020-05-09,Vent Availability,TSA-U,Corpus Christi,57,15,114,33,171,48,5,0,92,42,97,42,0,1,16
2020-05-09,Vent Availability,TSA-V,Lower Rio Grande Valley,35,3,233,86,268,89,17,0,163,66,180,66,3,3,45
2020-05-09,Vent Availability,Total,Texas,1195,366,4885,2380,6080,2746,346,53,3027,1215,3373,1268,176,378,1519
2020-05-10,Vent Availability,TSA-A,Amarillo,31,4,73,39,104,43,0,0,42,19,42,19,0,0,25
2020-05-10,Vent Availability,TSA-B,Lubbock,7,1,149,45,156,46,1,0,69,23,70,23,0,5,28
2020-05-10,Vent Availability,TSA-C,Witchita Falls,2,0,51,8,53,8,0,0,10,4,10,4,0,0,33
2020-05-10,Vent Availability,TSA-D,Abilene,9,0,53,1,62,1,0,0,20,1,20,1,0,0,28
2020-05-10,Vent Availability,TSA-E,Dallas/Ft. Worth,285,147,955,593,1240,740,69,22,720,271,789,293,102,156,328
2020-05-10,Vent Availability,TSA-F,Paris,12,0,81,25,93,25,16,0,58,20,74,20,0,10,38
2020-05-10,Vent Availability,TSA-G,Longview/Tyler,74,5,167,63,241,68,35,0,158,40,193,40,1,15,22
2020-05-10,Vent Availability,TSA-H,Lufkin,39,0,79,12,118,12,0,0,42,6,42,6,0,3,28
2020-05-10,Vent Availability,TSA-I,El Paso,58,9,204,74,262,83,4,1,101,31,105,32,7,20,57
2020-05-10,Vent Availability,TSA-J,Midland/Odessa,36,4,176,15,212,19,17,0,53,12,70,12,0,0,33
2020-05-10,Vent Availability,TSA-K,San Angelo,4,0,41,0,45,0,0,0,0,0,0,0,0,0,6
2020-05-10,Vent Availability,TSA-L,Belton/Killeen,25,1,65,4,90,5,2,0,41,5,43,5,0,4,31
2020-05-10,Vent Availability,TSA-M,Waco,0,0,61,15,61,15,0,0,61,10,61,10,0,1,16
2020-05-10,Vent Availability,TSA-N,Bryan/College Station,6,0,34,11,40,11,2,0,25,2,27,2,0,2,23
2020-05-10,Vent Availability,TSA-O,Austin,69,16,285,82,354,98,10,0,130,52,140,52,2,12,110
2020-05-10,Vent Availability,TSA-P,San Antonio,73,46,816,634,889,680,14,6,312,258,326,264,21,24,183
2020-05-10,Vent Availability,TSA-Q,Houston,311,86,981,481,1292,567,52,29,693,261,745,290,27,116,263
2020-05-10,Vent Availability,TSA-R,Galveston,43,3,177,100,220,103,21,1,131,48,152,49,26,7,98
2020-05-10,Vent Availability,TSA-S,Victoria,4,0,39,13,43,13,0,0,19,8,19,8,0,4,26
2020-05-10,Vent Availability,TSA-T,Laredo,21,0,54,24,75,24,5,0,36,9,41,9,0,9,6
2020-05-10,Vent Availability,TSA-U,Corpus Christi,58,15,114,34,172,49,5,0,92,43,97,43,0,1,16
2020-05-10,Vent Availability,TSA-V,Lower Rio Grande Valley,34,4,235,79,269,83,17,0,162,62,179,62,0,5,48
2020-05-10,Vent Availability,Total,Texas,1201,341,4890,2352,6091,2693,270,59,2975,1185,3245,1244,186,394,1446
2020-05-11,Vent Availability,TSA-A,Amarillo,25,3,77,40,102,43,0,0,53,14,53,14,0,0,25
2020-05-11,Vent Availability,TSA-B,Lubbock,7,1,146,48,153,49,1,0,70,22,71,22,0,5,24
2020-05-11,Vent Availability,TSA-C,Witchita Falls,2,0,51,8,53,8,0,0,10,4,10,4,0,0,27
2020-05-11,Vent Availability,TSA-D,Abilene,9,0,53,9,62,9,0,0,20,3,20,3,0,0,29
2020-05-11,Vent Availability,TSA-E,Dallas/Ft. Worth,288,145,1056,605,1344,750,67,24,810,295,877,319,125,146,377
2020-05-11,Vent Availability,TSA-F,Paris,12,0,76,29,88,29,16,0,57,24,73,24,0,0,38
2020-05-11,Vent Availability,TSA-G,Longview/Tyler,76,5,169,63,245,68,25,0,150,60,175,60,1,16,23
2020-05-11,Vent Availability,TSA-H,Lufkin,40,0,85,14,125,14,0,0,43,14,43,14,0,2,26
2020-05-11,Vent Availability,TSA-I,El Paso,67,8,202,67,269,75,4,1,101,37,105,38,5,17,49
2020-05-11,Vent Availability,TSA-J,Midland/Odessa,36,4,174,16,210,20,17,0,53,11,70,11,0,0,34
2020-05-11,Vent Availability,TSA-K,San Angelo,4,0,38,0,42,0,0,0,0,0,0,0,0,0,7
2020-05-11,Vent Availability,TSA-L,Belton/Killeen,28,5,132,34,160,39,5,0,110,14,115,14,1,3,50
2020-05-11,Vent Availability,TSA-M,Waco,0,0,60,16,60,16,0,0,62,1,62,1,0,1,11
2020-05-11,Vent Availability,TSA-N,Bryan/College Station,7,0,45,12,52,12,2,0,31,3,33,3,0,2,28
2020-05-11,Vent Availability,TSA-O,Austin,82,32,294,91,376,123,10,0,162,39,172,39,20,13,125
2020-05-11,Vent Availability,TSA-P,San Antonio,73,44,820,641,893,685,14,6,312,260,326,266,18,29,183
2020-05-11,Vent Availability,TSA-Q,Houston,306,80,1068,525,1374,605,96,17,710,332,806,349,127,123,200
2020-05-11,Vent Availability,TSA-R,Galveston,28,5,180,74,208,79,9,0,145,44,154,44,28,15,133
2020-05-11,Vent Availability,TSA-S,Victoria,4,0,46,7,50,7,0,0,22,5,22,5,0,1,26
2020-05-11,Vent Availability,TSA-T,Laredo,21,0,52,26,73,26,5,5,33,12,38,17,0,7,6
2020-05-11,Vent Availability,TSA-U,Corpus Christi,59,10,105,30,164,40,5,0,89,45,94,45,0,0,16
2020-05-11,Vent Availability,TSA-V,Lower Rio Grande Valley,46,8,231,80,277,88,16,0,160,59,176,59,0,6,48
2020-05-11,Vent Availability,Total,Texas,1220,350,5160,2435,6380,2785,292,53,3203,1298,3495,1351,325,386,1485
2020-05-13,Vent Availability,TSA-A,Amarillo,26,4,84,30,110,34,0,0,51,17,51,17,0,0,25
2020-05-13,Vent Availability,TSA-B,Lubbock,10,0,149,45,159,45,1,0,69,16,70,16,0,4,23
2020-05-13,Vent Availability,TSA-C,Witchita Falls,2,0,51,8,53,8,0,0,10,4,10,4,0,0,28
2020-05-13,Vent Availability,TSA-D,Abilene,9,0,52,11,61,11,0,0,20,1,20,1,0,0,28
2020-05-13,Vent Availability,TSA-E,Dallas/Ft. Worth,302,136,1019,650,1321,786,68,21,817,286,885,307,150,172,340
2020-05-13,Vent Availability,TSA-F,Paris,12,0,83,21,95,21,15,0,59,24,74,24,1,5,38
2020-05-13,Vent Availability,TSA-G,Longview/Tyler,72,6,162,69,234,75,22,0,142,57,164,57,1,17,23
2020-05-13,Vent Availability,TSA-H,Lufkin,25,0,80,19,105,19,4,0,31,21,35,21,0,3,25
2020-05-13,Vent Availability,TSA-I,El Paso,57,10,197,70,254,80,5,1,99,28,104,29,3,20,49
2020-05-13,Vent Availability,TSA-J,Midland/Odessa,36,4,175,15,211,19,17,0,50,15,67,15,0,0,34
2020-05-13,Vent Availability,TSA-K,San Angelo,4,0,43,0,47,0,0,0,0,0,0,0,0,0,3
2020-05-13,Vent Availability,TSA-L,Belton/Killeen,25,7,117,44,142,51,5,0,33,9,38,9,4,4,28
2020-05-13,Vent Availability,TSA-M,Waco,0,0,61,15,61,15,0,0,62,1,62,1,0,0,12
2020-05-13,Vent Availability,TSA-N,Bryan/College Station,6,0,34,11,40,11,2,0,25,1,27,1,0,1,27
2020-05-13,Vent Availability,TSA-O,Austin,87,30,313,94,400,124,10,0,187,55,197,55,5,17,140
2020-05-13,Vent Availability,TSA-P,San Antonio,73,37,819,637,892,674,14,9,312,248,326,257,21,23,183
2020-05-13,Vent Availability,TSA-Q,Houston,299,142,973,555,1272,697,109,20,716,305,825,325,141,111,220
2020-05-13,Vent Availability,TSA-R,Galveston,31,0,155,86,186,86,12,3,107,46,119,49,10,15,131
2020-05-13,Vent Availability,TSA-S,Victoria,3,1,44,9,47,10,0,0,22,5,22,5,0,5,26
2020-05-13,Vent Availability,TSA-T,Laredo,21,0,54,24,75,24,5,0,33,12,38,12,0,7,6
2020-05-13,Vent Availability,TSA-U,Corpus Christi,62,5,119,26,181,31,5,0,101,37,106,37,0,1,16
2020-05-13,Vent Availability,TSA-V,Lower Rio Grande Valley,33,9,229,84,262,93,16,0,163,70,179,70,6,6,47
2020-05-13,Vent Availability,Total,Texas,1195,391,5013,2523,6208,2914,310,54,3109,1258,3419,1312,342,411,1452
2020-05-15,Vent Availability,TSA-A,Amarillo,26,4,84,32,110,36,0,0,56,12,56,12,0,0,25
2020-05-15,Vent Availability,TSA-B,Lubbock,10,0,155,39,165,39,1,0,65,20,66,20,0,5,23
2020-05-15,Vent Availability,TSA-C,Witchita Falls,2,0,51,8,53,8,0,0,10,4,10,4,0,0,29
2020-05-15,Vent Availability,TSA-D,Abilene,9,0,53,10,62,10,0,0,20,1,20,1,0,0,29
2020-05-15,Vent Availability,TSA-E,Dallas/Ft. Worth,317,127,1041,639,1358,766,69,20,796,307,865,327,172,151,330
2020-05-15,Vent Availability,TSA-F,Paris,12,0,82,23,94,23,10,0,55,23,65,23,0,5,38
2020-05-15,Vent Availability,TSA-G,Longview/Tyler,80,5,171,59,251,64,29,0,150,47,179,47,0,13,23
2020-05-15,Vent Availability,TSA-H,Lufkin,34,8,71,23,105,31,0,0,37,20,37,20,0,0,22
2020-05-15,Vent Availability,TSA-I,El Paso,68,10,190,73,258,83,5,1,101,36,106,37,3,18,52
2020-05-15,Vent Availability,TSA-J,Midland/Odessa,38,2,176,17,214,19,17,0,57,16,74,16,0,0,34
2020-05-15,Vent Availability,TSA-K,San Angelo,4,0,37,0,41,0,0,0,0,0,0,0,0,0,3
2020-05-15,Vent Availability,TSA-L,Belton/Killeen,26,9,84,48,110,57,7,0,90,5,97,5,0,5,41
2020-05-15,Vent Availability,TSA-M,Waco,0,0,59,10,59,10,0,0,56,15,56,15,0,0,14
2020-05-15,Vent Availability,TSA-N,Bryan/College Station,7,0,43,13,50,13,2,0,30,6,32,6,0,3,28
2020-05-15,Vent Availability,TSA-O,Austin,76,27,316,101,392,128,13,4,157,43,170,47,15,19,129
2020-05-15,Vent Availability,TSA-P,San Antonio,73,41,817,41,890,82,14,7,314,246,328,253,20,23,183
2020-05-15,Vent Availability,TSA-Q,Houston,276,145,982,512,1258,657,117,17,632,330,749,347,162,90,227
2020-05-15,Vent Availability,TSA-R,Galveston,37,6,171,85,208,91,21,3,147,46,168,49,14,31,123
2020-05-15,Vent Availability,TSA-S,Victoria,3,4,47,10,50,14,0,0,20,7,20,7,0,3,26
2020-05-15,Vent Availability,TSA-T,Laredo,21,0,56,22,77,22,8,3,30,11,38,14,0,8,8
2020-05-15,Vent Availability,TSA-U,Corpus Christi,48,7,109,28,157,35,5,0,110,29,115,29,0,0,16
2020-05-15,Vent Availability,TSA-V,Lower Rio Grande Valley,41,4,235,70,276,74,1,0,144,81,145,81,2,0,49
2020-05-15,Vent Availability,Total,Texas,1208,399,5030,1863,6238,2262,319,55,3077,1305,3396,1360,388,374,1452
2020-05-18,Vent Availability,TSA-A,Amarillo,27,5,88,26,115,31,0,0,56,12,56,12,0,0,25
2020-05-18,Vent Availability,TSA-B,Lubbock,10,0,158,36,168,36,1,0,67,18,68,18,0,4,24
2020-05-18,Vent Availability,TSA-C,Witchita Falls,2,0,51,8,53,8,0,0,10,4,10,4,0,0,26
2020-05-18,Vent Availability,TSA-D,Abilene,9,0,53,10,62,10,0,0,21,1,21,1,0,0,29
2020-05-18,Vent Availability,TSA-E,Dallas/Ft. Worth,325,112,990,618,1315,730,66,23,747,314,813,337,148,172,332
2020-05-18,Vent Availability,TSA-F,Paris,12,0,87,17,99,17,10,0,51,28,61,28,0,4,38
2020-05-18,Vent Availability,TSA-G,Longview/Tyler,72,6,162,65,234,71,27,0,144,54,171,54,0,15,24
2020-05-18,Vent Availability,TSA-H,Lufkin,30,7,65,25,95,32,0,0,35,21,35,21,0,1,23
2020-05-18,Vent Availability,TSA-I,El Paso,70,7,208,65,278,72,5,0,108,43,113,43,6,19,50
2020-05-18,Vent Availability,TSA-J,Midland/Odessa,38,2,176,19,214,21,17,0,58,16,75,16,0,0,33
2020-05-18,Vent Availability,TSA-K,San Angelo,4,0,39,0,43,0,0,0,0,0,0,0,0,0,9
2020-05-18,Vent Availability,TSA-L,Belton/Killeen,33,2,141,45,174,47,5,0,102,29,107,29,0,5,46
2020-05-18,Vent Availability,TSA-M,Waco,0,0,58,17,58,17,0,0,60,3,60,3,0,1,12
2020-05-18,Vent Availability,TSA-N,Bryan/College Station,7,0,42,15,49,15,1,0,25,6,26,6,0,2,28
2020-05-18,Vent Availability,TSA-O,Austin,76,24,307,116,383,140,10,0,185,46,195,46,28,22,122
2020-05-18,Vent Availability,TSA-P,San Antonio,73,29,815,161,888,190,14,7,310,57,324,64,31,22,183
2020-05-18,Vent Availability,TSA-Q,Houston,291,123,866,543,1157,666,78,31,619,320,697,351,151,94,215
2020-05-18,Vent Availability,TSA-R,Galveston,30,8,140,92,170,100,11,1,144,47,155,48,19,31,142
2020-05-18,Vent Availability,TSA-S,Victoria,3,1,46,7,49,8,0,0,20,7,20,7,0,1,26
2020-05-18,Vent Availability,TSA-T,Laredo,21,0,49,25,70,25,8,0,29,15,37,15,0,7,6
2020-05-18,Vent Availability,TSA-U,Corpus Christi,44,12,113,26,157,38,5,0,103,36,108,36,0,0,16
2020-05-18,Vent Availability,TSA-V,Lower Rio Grande Valley,54,4,241,77,295,81,11,0,142,62,153,62,2,4,44
2020-05-18,Vent Availability,Total,Texas,1231,342,4895,2013,6126,2355,269,62,3036,1139,3305,1201,385,404,1453
2020-05-19,Vent Availability,TSA-A,Amarillo,27,5,90,23,117,28,0,0,49,19,49,19,0,0,25
2020-05-19,Vent Availability,TSA-B,Lubbock,10,0,133,36,143,36,1,0,61,24,62,24,0,4,22
2020-05-19,Vent Availability,TSA-C,Witchita Falls,2,0,49,8,51,8,0,0,10,4,10,4,0,0,28
2020-05-19,Vent Availability,TSA-D,Abilene,9,0,53,10,62,10,0,0,21,1,21,1,0,0,29
2020-05-19,Vent Availability,TSA-E,Dallas/Ft. Worth,313,119,1030,624,1343,743,66,23,739,325,805,348,164,148,349
2020-05-19,Vent Availability,TSA-F,Paris,12,0,83,22,95,22,11,0,55,24,66,24,0,4,38
2020-05-19,Vent Availability,TSA-G,Longview/Tyler,71,5,162,66,233,71,29,0,142,56,171,56,0,15,23
2020-05-19,Vent Availability,TSA-H,Lufkin,40,0,76,18,116,18,0,0,40,17,40,17,0,1,23
2020-05-19,Vent Availability,TSA-I,El Paso,70,7,209,67,279,74,5,0,106,39,111,39,1,22,44
2020-05-19,Vent Availability,TSA-J,Midland/Odessa,38,2,174,16,212,18,17,0,49,14,66,14,0,0,33
2020-05-19,Vent Availability,TSA-K,San Angelo,4,0,38,0,42,0,0,0,0,0,0,0,0,0,9
2020-05-19,Vent Availability,TSA-L,Belton/Killeen,34,0,150,44,184,44,5,0,103,32,108,32,0,6,47
2020-05-19,Vent Availability,TSA-M,Waco,0,0,59,16,59,16,0,0,58,3,58,3,0,0,8
2020-05-19,Vent Availability,TSA-N,Bryan/College Station,7,0,40,16,47,16,2,0,24,5,26,5,0,2,28
2020-05-19,Vent Availability,TSA-O,Austin,76,28,289,111,365,139,10,0,180,48,190,48,13,19,118
2020-05-19,Vent Availability,TSA-P,San Antonio,73,34,815,174,888,208,14,7,315,65,329,72,37,15,183
2020-05-19,Vent Availability,TSA-Q,Houston,372,125,1031,495,1403,620,91,20,703,347,794,367,160,117,206
2020-05-19,Vent Availability,TSA-R,Galveston,36,8,143,93,179,101,10,12,125,45,135,57,23,34,130
2020-05-19,Vent Availability,TSA-S,Victoria,3,1,46,7,49,8,0,0,22,5,22,5,0,1,26
2020-05-19,Vent Availability,TSA-T,Laredo,21,0,55,23,76,23,8,0,30,14,38,14,0,5,6
2020-05-19,Vent Availability,TSA-U,Corpus Christi,45,13,108,31,153,44,5,0,97,44,102,44,0,0,16
2020-05-19,Vent Availability,TSA-V,Lower Rio Grande Valley,30,2,238,80,268,82,11,0,136,69,147,69,2,7,47
2020-05-19,Vent Availability,Total,Texas,1293,349,5071,1980,6364,2329,285,62,3065,1200,3350,1262,400,400,1438
2020-05-21,Vent Availability,TSA-A,Amarillo,28,4,92,23,120,27,0,0,49,19,49,19,0,0,25
2020-05-21,Vent Availability,TSA-B,Lubbock,7,1,155,39,162,40,1,0,69,16,70,16,0,5,26
2020-05-21,Vent Availability,TSA-C,Witchita Falls,2,0,49,8,51,8,0,0,10,4,10,4,0,0,25
2020-05-21,Vent Availability,TSA-D,Abilene,9,0,53,8,62,8,0,0,21,1,21,1,0,0,29
2020-05-21,Vent Availability,TSA-E,Dallas/Ft. Worth,285,116,1039,593,1324,709,63,26,725,334,788,360,165,126,369
2020-05-21,Vent Availability,TSA-F,Paris,12,0,77,24,89,24,11,0,56,18,67,18,0,4,38
2020-05-21,Vent Availability,TSA-G,Longview/Tyler,65,4,157,74,222,78,25,0,137,60,162,60,0,11,23
2020-05-21,Vent Availability,TSA-H,Lufkin,27,0,63,18,90,18,0,0,45,13,45,13,0,1,20
2020-05-21,Vent Availability,TSA-I,El Paso,70,8,200,69,270,77,5,0,102,33,107,33,1,19,40
2020-05-21,Vent Availability,TSA-J,Midland/Odessa,38,2,177,13,215,15,17,0,55,10,72,10,0,0,33
2020-05-21,Vent Availability,TSA-K,San Angelo,4,0,41,0,45,0,0,0,0,0,0,0,0,0,9
2020-05-21,Vent Availability,TSA-L,Belton/Killeen,35,1,126,42,161,43,5,0,107,10,112,10,0,6,46
2020-05-21,Vent Availability,TSA-M,Waco,0,0,60,16,60,16,0,0,59,4,59,4,0,0,10
2020-05-21,Vent Availability,TSA-N,Bryan/College Station,7,0,46,13,53,13,2,0,26,4,28,4,0,2,28
2020-05-21,Vent Availability,TSA-O,Austin,86,27,294,113,380,140,10,0,171,45,181,45,30,17,106
2020-05-21,Vent Availability,TSA-P,San Antonio,73,44,815,190,888,234,14,9,314,253,328,262,34,14,183
2020-05-21,Vent Availability,TSA-Q,Houston,325,118,945,568,1270,686,92,16,683,319,775,335,174,128,198
2020-05-21,Vent Availability,TSA-R,Galveston,31,1,182,123,213,124,16,2,137,58,153,60,20,30,129
2020-05-21,Vent Availability,TSA-S,Victoria,3,1,45,8,48,9,0,0,19,8,19,8,0,1,26
2020-05-21,Vent Availability,TSA-T,Laredo,21,0,54,24,75,24,8,0,29,15,37,15,0,6,6
2020-05-21,Vent Availability,TSA-U,Corpus Christi,52,20,110,33,162,53,5,0,98,49,103,49,0,0,16
2020-05-21,Vent Availability,TSA-V,Lower Rio Grande Valley,69,1,229,73,298,74,11,0,150,64,161,64,1,7,44
2020-05-21,Vent Availability,Total,Texas,1249,348,5009,2072,6258,2420,285,53,3062,1337,3347,1390,425,377,1429
2020-05-20,Vent Availability,TSA-A,Amarillo,28,4,90,24,118,28,0,0,48,20,48,20,0,0,25
2020-05-20,Vent Availability,TSA-B,Lubbock,7,1,157,39,164,40,1,0,65,20,66,20,0,4,26
2020-05-20,Vent Availability,TSA-C,Witchita Falls,2,0,49,8,51,8,0,0,10,4,10,4,0,0,26
2020-05-20,Vent Availability,TSA-D,Abilene,9,0,53,8,62,8,0,0,21,1,21,1,0,0,29
2020-05-20,Vent Availability,TSA-E,Dallas/Ft. Worth,276,112,1044,607,1320,719,63,26,719,337,782,363,132,140,332
2020-05-20,Vent Availability,TSA-F,Paris,12,0,84,21,96,21,13,0,53,19,66,19,0,3,38
2020-05-20,Vent Availability,TSA-G,Longview/Tyler,67,5,153,76,220,81,25,0,135,62,160,62,0,12,25
2020-05-20,Vent Availability,TSA-H,Lufkin,27,0,73,20,100,20,0,0,42,15,42,15,0,1,23
2020-05-20,Vent Availability,TSA-I,El Paso,70,7,196,71,266,78,5,0,100,36,105,36,1,21,46
2020-05-20,Vent Availability,TSA-J,Midland/Odessa,38,2,174,16,212,18,17,0,81,14,98,14,0,0,33
2020-05-20,Vent Availability,TSA-K,San Angelo,4,0,39,0,43,0,0,0,0,0,0,0,0,0,9
2020-05-20,Vent Availability,TSA-L,Belton/Killeen,33,0,119,41,152,41,5,0,87,7,92,7,0,4,34
2020-05-20,Vent Availability,TSA-M,Waco,0,0,65,11,65,11,0,0,58,5,58,5,0,1,10
2020-05-20,Vent Availability,TSA-N,Bryan/College Station,7,0,46,13,53,13,2,0,28,3,30,3,0,2,28
2020-05-20,Vent Availability,TSA-O,Austin,96,29,302,115,398,144,14,0,186,45,200,45,13,18,151
2020-05-20,Vent Availability,TSA-P,San Antonio,73,36,815,105,888,141,14,7,314,78,328,85,40,17,183
2020-05-20,Vent Availability,TSA-Q,Houston,288,75,1120,574,1408,649,113,16,662,336,775,352,163,118,194
2020-05-20,Vent Availability,TSA-R,Galveston,49,26,168,86,217,112,26,9,91,61,117,70,39,34,62
2020-05-20,Vent Availability,TSA-S,Victoria,3,1,43,10,46,11,0,0,22,5,22,5,0,1,26
2020-05-20,Vent Availability,TSA-T,Laredo,21,0,56,22,77,22,8,0,30,14,38,14,0,6,6
2020-05-20,Vent Availability,TSA-U,Corpus Christi,52,19,109,31,161,50,5,0,93,45,98,45,0,0,16
2020-05-20,Vent Availability,TSA-V,Lower Rio Grande Valley,30,2,208,81,238,83,11,0,131,73,142,73,2,4,48
2020-05-20,Vent Availability,Total,Texas,1192,319,5163,1979,6355,2298,322,58,2976,1200,3298,1258,390,386,1370
